111111
1P0001
111101
1C10E1
111111
