11111
1P0C1
10001
1C1E1
11111
