111111111111111111111
1P0000000000000000001
111011111110001111101
1C00000000000000000E1
101111111100001111101
1C0000000000000000001
111111111111111111111