111111111111111111111
110000000000000000001
111011111110001111101
1C00000010000000000E1
101111111100001111101
1C000000000000000P001
111111111111111111111