111111111
1P0000001
111011101
1C00000E1
101111101
1C0000001
111111111