1111111
1P00001
1111011
1C100E1
1C11111
1111111
