1111111
1P001C1
1111011
1C100E1
1C11111
1111111
