11111111111111111111
1P000000011000000001
11101111011101111101
1C001000001000100001
10111101111111011111
1000000000C000001001
10111101111111110101
100000000000000000E1
11110111110111111111
11111111111111111111
