111111
1P0001
1C1111
1C00E1
111111
