111111
1P0C01
111001
1C00E1
111111
